5 5
3 2 W
#####
#...#
#DB.#
#...#
#####
