7 7
5 2 W
#######
#.....#
#...B.#
#.D...#
#.D.B.#
#.....#
#######
