8 6
1 2 W
########
#..#...#
#..B...#
#..#...#
#D.#..#.
#######.
