19 11
11 8 N
....#####..........
....#...#..........
....#B..#..........
..###..B##.........
..#..B.B.#.........
###.#.##.#...######
#...#.##.#####..DD#
#.B..B..........DD#
#####.###.#.##..DD#
....#.....#########
....#######........
